year,week,hometeam,awayteam,homescore,awayscore,pointdiff,hwhl,covered,homeline,awayline,predicttotal,actualtotal
2015,1,DEN,BAL,19,13,6,1,1,-4.5,4.5,49.5,32
2015,1,JAC,CAR,9,20,-11,0,0,3,-3,41,29
2015,1,OAK,CIN,13,33,-20,0,0,3.5,-3.5,43.5,46
2015,1,NYJ,CLE,31,10,21,1,1,-3,3,40,41
2015,1,SD,DET,33,28,5,1,1,-3,3,46,61
2015,1,CHI,GB,23,31,-8,0,0,6.5,-6.5,50,54
2015,1,BUF,IND,27,14,13,1,1,2.5,-2.5,46,41
2015,1,HOU,KC,20,27,-7,0,0,-1,1,41,47
2015,1,WAS,MIA,10,17,-7,0,0,3.5,-3.5,43,27
2015,1,SF,MIN,20,3,17,1,1,2.5,-2.5,41.5,23
2015,1,ARI,NO,31,19,12,1,1,-2.5,2.5,47,50
2015,1,DAL,NYG,27,26,1,1,0,-5.5,5.5,51.5,53
2015,1,ATL,PHI,26,24,2,1,1,3,-3,55,50
2015,1,NE,PIT,28,21,7,1,0,-7,7,52,49
2015,1,TB,TEN,14,42,-28,0,0,-3,3,42,56
2015,2,CHI,ARI,23,48,-25,0,0,1.5,-1.5,44.5,71
2015,2,NYG,ATL,20,24,-4,0,0,-2,2,51,44
2015,2,OAK,BAL,37,33,4,1,1,6,-6,43,70
2015,2,PHI,DAL,10,20,-10,0,0,-5.5,5.5,55,30
2015,2,KC,DEN,24,31,-7,0,0,-3,3,43.5,55
2015,2,MIN,DET,26,16,10,1,1,-3,3,44,42
2015,2,CAR,HOU,24,17,7,1,1,-3,3,40.5,41
2015,2,JAC,MIA,23,20,3,1,1,6,-6,41.5,43
2015,2,BUF,NE,32,40,-8,0,0,0,0,45,72
2015,2,IND,NYJ,7,20,-13,0,0,-7,7,47,27
2015,2,CIN,SD,24,19,5,1,1,-3.5,3.5,45.5,43
2015,2,GB,SEA,27,17,10,1,1,-3,3,49,44
2015,2,PIT,SF,43,18,25,1,1,-5,5,44,61
2015,2,NO,TB,19,26,-7,0,0,-10.5,10.5,48.5,45
2015,2,CLE,TEN,28,14,14,1,1,-2.5,2.5,41.5,42
2015,3,DAL,ATL,28,39,-11,0,0,0,0,44,67
2015,3,MIA,BUF,14,41,-27,0,0,-2.5,2.5,44,55
2015,3,SEA,CHI,26,0,26,1,1,-14.5,14.5,45,26
2015,3,BAL,CIN,24,28,-4,0,0,-3,3,44.5,52
2015,3,DET,DEN,12,24,-12,0,0,3.5,-3.5,44.5,36
2015,3,TEN,IND,33,35,-2,0,1,3.5,-3.5,45,68
2015,3,GB,KC,38,28,10,1,1,-6.5,6.5,48,66
2015,3,CAR,NO,27,22,5,1,1,-3,3,45,49
2015,3,CLE,OAK,20,27,-7,0,0,-4.5,4.5,41.5,47
2015,3,NYJ,PHI,17,24,-7,0,0,0,0,47,41
2015,3,MIN,SD,31,14,17,1,1,-3,3,45,45
2015,3,ARI,SF,47,7,40,1,1,-6,6,44,54
2015,3,HOU,TB,19,9,10,1,1,-7,7,40.5,28
2015,3,NYG,WAS,32,21,11,1,1,-4,4,44,53
2015,4,PIT,BAL,20,23,-3,0,0,2,-2,45.5,43
2015,4,TB,CAR,23,37,-14,0,0,3,-3,39.5,60
2015,4,SD,CLE,30,27,3,1,0,-7,7,44.5,57
2015,4,NO,DAL,26,20,6,1,1,-3.5,3.5,47,46
2015,4,SEA,DET,13,10,3,1,0,-10,10,42.5,23
2015,4,SF,GB,3,17,-14,0,0,8.5,-8.5,47.5,20
2015,4,ATL,HOU,48,21,27,1,1,-5,5,46.5,69
2015,4,CIN,KC,36,21,15,1,1,-4,4,44,57
2015,4,DEN,MIN,23,20,3,1,0,-6.5,6.5,43.5,43
2015,4,BUF,NYG,10,24,-14,0,0,-5.5,5.5,47,34
2015,4,MIA,NYJ,14,27,-13,0,0,-1,1,41,41
2015,4,CHI,OAK,22,20,2,1,1,2.5,-2.5,44.5,42
2015,4,WAS,PHI,23,20,3,1,1,3,-3,47.5,43
2015,5,DET,ARI,17,42,-25,0,0,2.5,-2.5,44,59
2015,5,TEN,BUF,13,14,-1,0,1,3,-3,42.5,27
2015,5,KC,CHI,17,18,-1,0,0,-10,10,45.5,35
2015,5,BAL,CLE,30,33,-3,0,0,-6.5,6.5,44,63
2015,5,OAK,DEN,10,16,-6,0,0,5.5,-5.5,43.5,26
2015,5,HOU,IND,20,27,-7,0,0,-1.5,1.5,44.5,47
2015,5,DAL,NE,6,30,-24,0,0,7.5,-7.5,49,36
2015,5,PHI,NO,39,17,22,1,1,-5,5,48,56
2015,5,SD,PIT,20,24,-4,0,0,-3,3,45.5,44
2015,5,CIN,SEA,27,24,3,1,0,-3,3,43,51
2015,5,NYG,SF,30,27,3,1,0,-7,7,43,57
2015,5,ATL,WAS,25,19,6,1,0,-8,8,47.5,44
2015,6,PIT,ARI,25,13,12,1,1,3,-3,44,38
2015,6,NO,ATL,31,21,10,1,1,3,-3,51,52
2015,6,SF,BAL,25,20,5,1,1,3,-3,44,45
2015,6,SEA,CAR,23,27,-4,0,0,-6.5,6.5,42,50
2015,6,DET,CHI,37,34,3,1,1,-2.5,2.5,44,71
2015,6,BUF,CIN,21,34,-13,0,0,-1,1,45,55
2015,6,CLE,DEN,23,26,-3,0,1,4.5,-4.5,42.5,49
2015,6,JAC,HOU,20,31,-11,0,0,0,0,42.5,51
2015,6,IND,JAC,16,13,3,1,0,-8.5,8.5,47,29
2015,6,HOU,JAC,30,6,24,1,1,-6,6,45,36
2015,6,MIN,KC,16,10,6,1,1,-3.5,3.5,44.5,26
2015,6,TEN,MIA,10,38,-28,0,0,-3,3,44.5,48
2015,6,IND,NE,27,34,-7,0,1,7.5,-7.5,55,61
2015,6,PHI,NYG,27,7,20,1,1,-3.5,3.5,50,34
2015,6,GB,SD,27,20,7,1,0,-10,10,50,47
2015,6,NYJ,WAS,34,20,14,1,1,-5.5,5.5,41.5,54
2015,7,TEN,ATL,7,10,-3,0,1,3.5,-3.5,47.5,17
2015,7,ARI,BAL,26,18,8,1,1,-7.5,7.5,48.5,44
2015,7,JAC,BUF,34,31,3,1,1,4,-4,42,65
2015,7,NYG,DAL,27,20,7,1,1,-5,5,45.5,47
2015,7,MIA,HOU,44,26,18,1,1,-5,5,43,70
2015,7,NE,JAC,51,17,34,1,1,-13.5,13.5,48,68
2015,7,DET,MIN,19,28,-9,0,0,2.5,-2.5,44.5,47
2015,7,IND,NO,21,27,-6,0,0,-6,6,52.5,48
2015,7,NE,NYJ,30,23,7,1,0,-10,10,48,53
2015,7,SD,OAK,29,37,-8,0,0,-5,5,47,66
2015,7,CAR,PHI,27,16,11,1,1,-3.5,3.5,46.5,43
2015,7,KC,PIT,23,13,10,1,1,-2,2,43,36
2015,7,SF,SEA,3,20,-17,0,0,4.5,-4.5,41.5,23
2015,7,WAS,TB,31,30,1,1,0,-3.5,3.5,44,61
2015,8,CLE,ARI,20,34,-14,0,0,4.5,-4.5,46,54
2015,8,PIT,CIN,10,16,-6,0,0,1.5,-1.5,48.5,26
2015,8,KC,DET,45,10,35,1,1,-6,6,45.5,55
2015,8,DEN,GB,29,10,19,1,1,2.5,-2.5,46,39
2015,8,CAR,IND,29,26,3,1,0,-6.5,6.5,46,55
2015,8,NE,MIA,36,7,29,1,1,-8,8,51.5,43
2015,8,CHI,MIN,20,23,-3,0,0,2.5,-2.5,42,43
2015,8,NO,NYG,52,49,3,1,0,-3.5,3.5,49,101
2015,8,OAK,NYJ,34,20,14,1,1,0,0,44,54
2015,8,BAL,SD,29,26,3,1,0,-3,3,50,55
2015,8,DAL,SEA,12,13,-1,0,1,5.5,-5.5,40.5,25
2015,8,ATL,TB,20,23,-3,0,0,-7.5,7.5,49,43
2015,8,HOU,TEN,20,6,14,1,1,-4.5,4.5,43.5,26
2015,9,SF,ATL,17,16,1,1,1,4,-4,45,33
2015,9,SD,CHI,19,22,-3,0,0,-4,4,50,41
2015,9,CIN,CLE,31,10,21,1,1,-10.5,10.5,46,41
2015,9,IND,DEN,27,24,3,1,1,3,-3,45,51
2015,9,CAR,GB,37,29,8,1,1,2.5,-2.5,46.5,66
2015,9,TB,JAC,38,31,7,1,1,-3,3,42,69
2015,9,BUF,MIA,33,17,16,1,1,-3,3,44,50
2015,9,TB,NYG,18,32,-14,0,0,2.5,-2.5,47,50
2015,9,PIT,OAK,38,35,3,1,0,-5.5,5.5,48,73
2015,9,DAL,PHI,27,33,-6,0,0,3,-3,44.5,60
2015,9,NO,TEN,28,34,-6,0,0,-7.5,7.5,48,62
2015,9,NE,WAS,27,10,17,1,1,-14,14,52.5,37
2015,10,SEA,ARI,32,39,-7,0,0,-3,3,45,71
2015,10,NYJ,BUF,17,22,-5,0,0,-3,3,43,39
2015,10,TEN,CAR,10,27,-17,0,0,4,-4,42,37
2015,10,PIT,CLE,30,9,21,1,1,-4.5,4.5,41,39
2015,10,TB,DAL,10,6,4,1,1,-1,1,43,16
2015,10,GB,DET,16,18,-2,0,0,-13,13,47.5,34
2015,10,CIN,HOU,6,10,-4,0,0,-10.5,10.5,47,16
2015,10,NYJ,JAC,28,23,5,1,0,-7.5,7.5,43,51
2015,10,DEN,KC,13,29,-16,0,0,-7,7,42.5,42
2015,10,PHI,MIA,19,20,-1,0,0,-6.5,6.5,46.5,39
2015,10,OAK,MIN,14,30,-16,0,0,-3,3,43.5,44
2015,10,NYG,NE,26,27,-1,0,1,7.5,-7.5,55,53
2015,10,WAS,NO,47,14,33,1,1,0,0,51,61
2015,11,NE,BUF,20,13,7,1,0,-7.5,7.5,49,33
2015,11,ARI,CIN,34,31,3,1,0,-3.5,3.5,47,65
2015,11,MIA,DAL,14,24,-10,0,0,-1,1,46,38
2015,11,CHI,DEN,15,17,-2,0,0,2,-2,43,32
2015,11,MIN,GB,13,30,-17,0,0,-1,1,45,43
2015,11,ATL,IND,21,24,-3,0,0,-6,6,47.5,45
2015,11,SD,KC,3,33,-30,0,0,3,-3,45.5,36
2015,11,HOU,NYJ,24,17,7,1,1,3,-3,40,41
2015,11,DET,OAK,18,13,5,1,1,1,-1,47.5,31
2015,11,SEA,SF,29,13,16,1,1,-13,13,40.5,42
2015,11,PHI,TB,17,45,-28,0,0,-6,6,45.5,62
2015,11,CAR,WAS,44,16,28,1,1,-7.5,7.5,45.5,60
2015,12,SF,ARI,13,19,-6,0,1,10.5,-10.5,44.5,32
2015,12,CLE,BAL,27,33,-6,0,0,-1,1,41,60
2015,12,KC,BUF,30,22,8,1,1,-6,6,42,52
2015,12,DAL,CAR,14,33,-19,0,0,-1,1,46,47
2015,12,GB,CHI,13,17,-4,0,0,-8,8,47.5,30
2015,12,NYJ,MIA,38,20,18,1,1,-4,4,42.5,58
2015,12,ATL,MIN,10,20,-10,0,0,-2.5,2.5,46,30
2015,12,DEN,NE,30,24,6,1,1,3.5,-3.5,45,54
2015,12,HOU,NO,24,6,18,1,1,-3,3,48,30
2015,12,WAS,NYG,20,14,6,1,1,1,-1,46.5,34
2015,12,TEN,OAK,21,24,-3,0,0,2,-2,44,45
2015,12,DET,PHI,45,14,31,1,1,1,-1,46,59
2015,12,SEA,PIT,39,30,9,1,1,-5.5,5.5,44.5,69
2015,12,JAC,SD,25,31,-6,0,0,-4,4,46.5,56
2015,12,IND,TB,25,12,13,1,1,-3,3,46.5,37
2015,13,TB,ATL,23,19,4,1,1,-2.5,2.5,45.5,42
2015,13,MIA,BAL,15,13,2,1,0,-4.5,4.5,43.5,28
2015,13,NO,CAR,38,41,-3,0,1,6.5,-6.5,49.5,79
2015,13,CLE,CIN,3,37,-34,0,0,10,-10,43.5,40
2015,13,WAS,DAL,16,19,-3,0,0,-4,4,42,35
2015,13,SD,DEN,3,17,-14,0,0,4,-4,43,20
2015,13,DET,GB,23,27,-4,0,1,5,-5,47.5,50
2015,13,BUF,HOU,30,21,9,1,1,-3.5,3.5,41.5,51
2015,13,PIT,IND,45,10,35,1,1,-7,7,47.5,55
2015,13,OAK,KC,20,34,-14,0,0,3,-3,44.5,54
2015,13,NYG,NYJ,20,23,-3,0,0,1,-1,45,43
2015,13,NE,PHI,28,35,-7,0,0,-10,10,48.5,63
2015,13,MIN,SEA,7,38,-31,0,0,1,-1,42,45
2015,13,CHI,SF,20,26,-6,0,0,-7,7,41.5,46
2015,13,JAC,TEN,19,13,6,1,1,-3,3,44.5,32
2015,14,CAR,ATL,38,0,38,1,1,-7.5,7.5,47,38
2015,14,PHI,BUF,23,20,3,1,1,-2,2,46.5,43
2015,14,GB,DAL,28,7,21,1,1,-7.5,7.5,43,35
2015,14,JAC,IND,51,16,35,1,1,1,-1,45,67
2015,14,BAL,JAC,20,22,-2,0,0,-6.5,6.5,48,42
2015,14,ARI,MIN,23,20,3,1,0,-7.5,7.5,45,43
2015,14,HOU,NE,6,27,-21,0,0,3.5,-3.5,45,33
2015,14,TB,NO,17,24,-7,0,0,-3.5,3.5,51,41
2015,14,MIA,NYG,24,31,-7,0,0,-2,2,46.5,55
2015,14,DEN,OAK,12,15,-3,0,0,-7.5,7.5,43.5,27
2015,14,CIN,PIT,20,33,-13,0,0,-3,3,47.5,53
2015,14,KC,SD,10,3,7,1,0,-10.5,10.5,46.5,13
2015,14,BAL,SEA,6,35,-29,0,0,10.5,-10.5,43,41
2015,14,CLE,SF,24,10,14,1,1,-1.5,1.5,40.5,34
2015,14,NYJ,TEN,30,8,22,1,1,-7.5,7.5,43.5,38
2015,14,CHI,WAS,21,24,-3,0,0,-3.5,3.5,43.5,45
2015,15,PHI,ARI,17,40,-23,0,0,3.5,-3.5,50.5,57
2015,15,JAC,ATL,17,23,-6,0,0,-3,3,48,40
2015,15,WAS,BUF,35,25,10,1,1,1,-1,44,60
2015,15,NYG,CAR,35,38,-3,0,1,4,-4,48,73
2015,15,MIN,CHI,38,17,21,1,1,-5,5,43,55
2015,15,SF,CIN,14,24,-10,0,0,4.5,-4.5,42,38
2015,15,SEA,CLE,30,13,17,1,1,-14.5,14.5,43,43
2015,15,PIT,DEN,34,27,7,1,1,-6,6,45,61
2015,15,NO,DET,27,35,-8,0,0,-3,3,50,62
2015,15,OAK,GB,20,30,-10,0,0,3,-3,45.5,50
2015,15,IND,HOU,10,16,-6,0,0,0,0,41,26
2015,15,BAL,KC,14,34,-20,0,0,7,-7,43,48
2015,15,SD,MIA,30,14,16,1,1,-1.5,1.5,44.5,44
2015,15,DAL,NYJ,16,19,-3,0,0,3,-3,42,35
2015,15,NE,TEN,33,16,17,1,1,-13.5,13.5,46.5,49
2015,16,ATL,CAR,20,13,7,1,1,7,-7,47,33
2015,16,TB,CHI,21,26,-5,0,0,-3,3,45.5,47
2015,16,DEN,CIN,20,17,3,1,0,-3.5,3.5,42,37
2015,16,KC,CLE,17,13,4,1,0,-12.5,12.5,43,30
2015,16,BUF,DAL,16,6,10,1,1,-6,6,43.5,22
2015,16,ARI,GB,38,8,30,1,1,-4.5,4.5,49.5,46
2015,16,TEN,HOU,6,34,-28,0,0,4.5,-4.5,42,40
2015,16,MIA,IND,12,18,-6,0,0,-1.5,1.5,44,30
2015,16,NO,JAC,38,27,11,1,1,-3.5,3.5,51.5,65
2015,16,TEN,JAC,42,39,3,1,1,-2.5,2.5,43,81
2015,16,NYJ,NE,26,20,6,1,1,3,-3,46,46
2015,16,MIN,NYG,49,17,32,1,1,-6.5,6.5,46,66
2015,16,BAL,PIT,20,17,3,1,1,10.5,-10.5,47.5,37
2015,16,OAK,SD,23,20,3,1,0,-4.5,4.5,46.5,43
2015,16,DET,SF,32,17,15,1,1,-8,8,43,49
2015,16,PHI,WAS,24,38,-14,0,0,-3.5,3.5,48,62
2015,17,CIN,BAL,24,16,8,1,1,-7.5,7.5,43,40
2015,17,CHI,DET,20,24,-4,0,0,-1.5,1.5,45,44
2015,17,GB,MIN,13,20,-7,0,0,-3,3,47.5,33
2015,17,MIA,NE,20,10,10,1,1,10.5,-10.5,47,30
2015,17,ATL,NO,17,20,-3,0,0,-4,4,53,37
2015,17,BUF,NYJ,22,17,5,1,1,1.5,-1.5,43,39
2015,17,KC,OAK,23,17,6,1,0,-7,7,44,40
2015,17,NYG,PHI,30,35,-5,0,0,-3.5,3.5,51.5,65
2015,17,CLE,PIT,12,28,-16,0,0,10,-10,47,40
2015,17,DEN,SD,27,20,7,1,0,-7.5,7.5,41,47
2015,17,ARI,SEA,6,36,-30,0,0,-3.5,3.5,47.5,42
2015,17,CAR,TB,38,10,28,1,1,-10.5,10.5,47,48
2015,17,IND,TEN,30,24,6,1,1,-3.5,3.5,39.5,54
2015,17,DAL,WAS,23,34,-11,0,0,-3.5,3.5,39.5,57
2016,1,BAL,BUF,13,7,6,1,1,-3,3,44.5,20
2016,1,DEN,CAR,21,20,1,1,1,3,-3,42,41
2016,1,HOU,CHI,23,14,9,1,1,-5.5,5.5,44,37
2016,1,NYJ,CIN,22,23,-1,0,1,2,-2,41.5,45
2016,1,PHI,CLE,29,10,19,1,1,-5.5,5.5,43,39
2016,1,IND,DET,35,39,-4,0,0,-3.5,3.5,51.5,74
2016,1,JAC,GB,23,27,-4,0,0,4,-4,48,50
2016,1,SF,LARM,28,0,28,1,1,2.5,-2.5,44,28
2016,1,SEA,MIA,12,10,2,1,0,-10.5,10.5,44,22
2016,1,TEN,MIN,16,25,-9,0,0,0,0,41,41
2016,1,ARI,NE,21,23,-2,0,0,-5.5,5.5,47.5,44
2016,1,DAL,NYG,19,20,-1,0,0,0,0,46.5,39
2016,1,NO,OAK,34,35,-1,0,0,-1,1,51,69
2016,1,WAS,PIT,16,38,-22,0,0,3,-3,50,54
2016,1,KC,SD,33,27,6,1,0,-7,7,44.5,60
2016,1,ATL,TB,24,31,-7,0,0,-3,3,47.5,55
2016,2,OAK,ATL,28,35,-7,0,0,-5.5,5.5,48,63
2016,2,CLE,BAL,20,25,-5,0,0,4.5,-4.5,43.5,45
2016,2,PIT,CIN,24,16,8,1,1,-3,3,48.5,40
2016,2,WAS,DAL,23,27,-4,0,0,-2.5,2.5,46.5,50
2016,2,MIN,GB,17,14,3,1,1,2,-2,44.5,31
2016,2,DEN,IND,34,20,14,1,1,-4.5,4.5,45,54
2016,2,SD,JAC,38,14,24,1,1,-2.5,2.5,47.5,52
2016,2,HOU,KC,19,12,7,1,1,-2,2,43.5,31
2016,2,NE,MIA,31,24,7,1,1,-5.5,5.5,42.5,55
2016,2,NYG,NO,16,13,3,1,0,-5,5,51.5,29
2016,2,BUF,NYJ,31,37,-6,0,0,-3,3,42.5,68
2016,2,CHI,PHI,14,29,-15,0,0,-2.5,2.5,42.5,43
2016,2,LARM,SEA,9,3,6,1,1,7,-7,38.5,12
2016,2,CAR,SF,46,27,19,1,1,-13,13,44.5,73
2016,2,ARI,TB,40,7,33,1,1,-7,7,50,47
2016,2,DET,TEN,15,16,-1,0,0,-5.5,5.5,46.5,31
2016,3,BUF,ARI,33,18,15,1,1,4,-4,47,51
2016,3,NO,ATL,32,45,-13,0,0,-3,3,53.5,77
2016,3,JAC,BAL,17,19,-2,0,0,0,0,47.5,36
2016,3,DAL,CHI,31,17,14,1,1,-5.5,5.5,45,48
2016,3,MIA,CLE,30,24,6,1,0,-7,7,41.5,54
2016,3,CIN,DEN,17,29,-12,0,0,-3.5,3.5,41,46
2016,3,GB,DET,34,27,7,1,0,-8.5,8.5,48,61
2016,3,NE,HOU,27,0,27,1,1,0,0,40.5,27
2016,3,TB,LARM,32,37,-5,0,0,-4,4,42,69
2016,3,CAR,MIN,10,22,-12,0,0,-7.5,7.5,43,32
2016,3,KC,NYJ,24,3,21,1,1,-3,3,43.5,27
2016,3,TEN,OAK,10,17,-7,0,0,0,0,47,27
2016,3,PHI,PIT,34,3,31,1,1,4,-4,46,37
2016,3,IND,SD,26,22,4,1,1,-2.5,2.5,50.5,48
2016,3,SEA,SF,37,18,19,1,1,-10,10,40.5,55
2016,3,NYG,WAS,27,29,-2,0,0,-4,4,46.5,56
2016,4,NE,BUF,0,16,-16,0,0,-7.5,7.5,44.5,16
2016,4,ATL,CAR,48,33,15,1,1,3.5,-3.5,50,81
2016,4,WAS,CLE,31,20,11,1,1,-10,10,45.5,51
2016,4,SF,DAL,17,24,-7,0,0,3,-3,46,41
2016,4,TB,DEN,7,27,-20,0,0,3,-3,44.5,34
2016,4,CHI,DET,17,14,3,1,1,3,-3,46,31
2016,4,JAC,IND,30,27,3,1,1,2,-2,49.5,57
2016,4,PIT,KC,43,14,29,1,1,-5,5,47.5,57
2016,4,ARI,LARM,13,17,-4,0,0,-8.5,8.5,43.5,30
2016,4,CIN,MIA,22,7,15,1,1,-7,7,44.5,29
2016,4,SD,NO,34,35,-1,0,0,-4.5,4.5,53.5,69
2016,4,MIN,NYG,24,10,14,1,1,-3.5,3.5,43.5,34
2016,4,BAL,OAK,27,28,-1,0,0,-3.5,3.5,46.5,55
2016,4,NYJ,SEA,17,27,-10,0,0,2.5,-2.5,41.5,44
2016,4,HOU,TEN,27,20,7,1,1,-6.5,6.5,40.5,47
2016,5,SF,ARI,21,33,-12,0,0,2.5,-2.5,42.5,54
2016,5,DEN,ATL,16,23,-7,0,0,-4.5,4.5,47,39
2016,5,LARM,BUF,19,30,-11,0,0,-2.5,2.5,40,49
2016,5,IND,CHI,29,23,6,1,1,-4.5,4.5,47.5,52
2016,5,DAL,CIN,28,14,14,1,1,0,0,45,42
2016,5,MIN,HOU,31,13,18,1,1,-6.5,6.5,40,44
2016,5,CLE,NE,13,33,-20,0,0,10.5,-10.5,46.5,46
2016,5,GB,NYG,23,16,7,1,0,-7.5,7.5,48,39
2016,5,PIT,NYJ,31,13,18,1,1,-7.5,7.5,48.5,44
2016,5,DET,PHI,24,23,1,1,1,2.5,-2.5,46,47
2016,5,OAK,SD,34,31,3,1,0,-4,4,51.5,65
2016,5,CAR,TB,14,17,-3,0,0,-4.5,4.5,45.5,31
2016,5,MIA,TEN,17,30,-13,0,0,-3.5,3.5,43.5,47
2016,5,BAL,WAS,10,16,-6,0,0,-3.5,3.5,46.5,26
2016,6,SEA,ATL,26,24,2,1,0,-6,6,45.5,50
2016,6,NYG,BAL,27,23,4,1,1,-3,3,43.5,50
2016,6,NO,CAR,41,38,3,1,1,3,-3,53,79
2016,6,NE,CIN,35,17,18,1,1,-8,8,47,52
2016,6,TEN,CLE,28,26,2,1,0,-7,7,44,54
2016,6,GB,DAL,16,30,-14,0,0,-4,4,46.5,46
2016,6,SD,DEN,21,13,8,1,1,2.5,-2.5,45.5,34
2016,6,HOU,IND,26,23,3,1,0,-3.5,3.5,46,49
2016,6,CHI,JAC,16,17,-1,0,0,-2,2,47,33
2016,6,OAK,KC,10,26,-16,0,0,-2,2,46.5,36
2016,6,DET,LARM,31,28,3,1,0,-3,3,44,59
2016,6,ARI,NYJ,28,3,25,1,1,-7.5,7.5,46,31
2016,6,WAS,PHI,27,20,7,1,1,2,-2,44.5,47
2016,6,MIA,PIT,30,15,15,1,1,7.5,-7.5,48,45
2016,6,BUF,SF,45,16,29,1,1,-7.5,7.5,44,61
2016,7,NYJ,BAL,24,16,8,1,1,-1,1,41.5,40
2016,7,MIA,BUF,28,25,3,1,1,2.5,-2.5,44,53
2016,7,GB,CHI,26,10,16,1,1,-9,9,47,36
2016,7,CIN,CLE,31,17,14,1,1,-10,10,45.5,48
2016,7,DEN,HOU,27,9,18,1,1,-7.5,7.5,40.5,36
2016,7,TEN,IND,26,34,-8,0,0,-2.5,2.5,48.5,60
2016,7,PHI,MIN,21,10,11,1,1,2,-2,40,31
2016,7,PIT,NE,16,27,-11,0,0,7.5,-7.5,45.5,43
2016,7,KC,NO,27,21,6,1,0,-7,7,50,48
2016,7,LARM,NYG,10,17,-7,0,0,2.5,-2.5,43.5,27
2016,7,JAC,OAK,16,33,-17,0,0,-1.5,1.5,48.5,49
2016,7,ATL,SD,30,33,-3,0,0,-6.5,6.5,50.5,63
2016,7,ARI,SEA,6,6,0,0,0,-2,2,43.5,12
2016,7,SF,TB,17,34,-17,0,0,2,-2,47,51
2016,7,DET,WAS,20,17,3,1,1,-1,1,48.5,37
2016,8,CAR,ARI,30,20,10,1,1,-2.5,2.5,48,50
2016,8,HOU,DET,20,13,7,1,1,-2.5,2.5,45,33
2016,8,ATL,GB,33,32,1,1,0,-2.5,2.5,52.5,65
2016,8,TEN,JAC,36,22,14,1,1,-3.5,3.5,46,58
2016,8,IND,KC,14,30,-16,0,0,2.5,-2.5,49.5,44
2016,8,CHI,MIN,20,10,10,1,1,5,-5,41,30
2016,8,BUF,NE,25,41,-16,0,0,5,-5,47.5,66
2016,8,CLE,NYJ,28,31,-3,0,0,3,-3,43.5,59
2016,8,TB,OAK,24,30,-6,0,0,-1,1,49,54
2016,8,DAL,PHI,29,23,6,1,1,-4.5,4.5,43.5,52
2016,8,DEN,SD,27,19,8,1,1,-5.5,5.5,43.5,46
2016,8,NO,SEA,25,20,5,1,1,3.5,-3.5,47.5,45
2016,8,CIN,WAS,27,27,0,0,0,-2.5,2.5,46.5,54
2016,9,TB,ATL,28,43,-15,0,0,3,-3,51.5,71
2016,9,SEA,BUF,31,25,6,1,0,-7,7,44,56
2016,9,LARM,CAR,10,13,-3,0,0,2.5,-2.5,45.5,23
2016,9,CLE,DAL,10,35,-25,0,0,7.5,-7.5,47,45
2016,9,OAK,DEN,30,20,10,1,1,-2.5,2.5,44.5,50
2016,9,MIN,DET,16,22,-6,0,0,-6,6,41,38
2016,9,GB,IND,26,31,-5,0,0,-7,7,53,57
2016,9,KC,JAC,19,14,5,1,0,-7.5,7.5,45,33
2016,9,SF,NO,23,41,-18,0,0,3,-3,51,64
2016,9,MIA,NYJ,27,23,4,1,1,-3,3,44,50
2016,9,NYG,PHI,28,23,5,1,1,-3,3,43,51
2016,9,BAL,PIT,21,14,7,1,1,-2.5,2.5,44,35
2016,9,SD,TEN,43,35,8,1,1,-4,4,48,78
2016,10,PHI,ATL,24,15,9,1,1,-1,1,49.5,39
2016,10,TB,CHI,36,10,26,1,1,0,0,45.5,46
2016,10,NYG,CIN,21,20,1,1,0,-2.5,2.5,47,41
2016,10,BAL,CLE,28,7,21,1,1,-10.5,10.5,45.5,35
2016,10,PIT,DAL,30,35,-5,0,0,-2.5,2.5,51,65
2016,10,NO,DEN,23,25,-2,0,0,-1.5,1.5,48,48
2016,10,TEN,GB,47,25,22,1,1,2.5,-2.5,48.5,72
2016,10,JAC,HOU,21,24,-3,0,0,0,0,42.5,45
2016,10,CAR,KC,17,20,-3,0,0,-3,3,44,37
2016,10,NYJ,LARM,6,9,-3,0,0,-2.5,2.5,41,15
2016,10,SD,MIA,24,31,-7,0,0,-3.5,3.5,47.5,55
2016,10,WAS,MIN,26,20,6,1,1,-2.5,2.5,42.5,46
2016,10,NE,SEA,24,31,-7,0,0,-7.5,7.5,48.5,55
2016,10,ARI,SF,23,20,3,1,0,-13,13,48,43
2016,11,MIN,ARI,30,24,6,1,1,0,0,41.5,54
2016,11,DAL,BAL,27,17,10,1,1,-7.5,7.5,45,44
2016,11,CIN,BUF,12,16,-4,0,0,-3,3,47,28
2016,11,NYG,CHI,22,16,6,1,0,-7,7,45.5,38
2016,11,WAS,GB,42,24,18,1,1,-2.5,2.5,50,66
2016,11,OAK,HOU,27,20,7,1,1,-5,5,46,47
2016,11,DET,JAC,26,19,7,1,1,-6.5,6.5,47,45
2016,11,LARM,MIA,10,14,-4,0,0,-1,1,40.5,24
2016,11,SF,NE,17,30,-13,0,1,13.5,-13.5,51.5,47
2016,11,CAR,NO,23,20,3,1,0,-4,4,51,43
2016,11,SEA,PHI,26,15,11,1,1,-6,6,45.5,41
2016,11,CLE,PIT,9,24,-15,0,0,9,-9,49.5,33
2016,11,KC,TB,17,19,-2,0,0,-7.5,7.5,44.5,36
2016,11,IND,TEN,24,17,7,1,1,-3,3,52,41
2016,12,ATL,ARI,38,19,19,1,1,-4,4,50.5,57
2016,12,OAK,CAR,35,32,3,1,0,-3.5,3.5,48,67
2016,12,BAL,CIN,19,14,5,1,1,-3.5,3.5,41.5,33
2016,12,PHI,GB,13,27,-14,0,0,-3.5,3.5,48,40
2016,12,BUF,JAC,28,21,7,1,0,-7,7,45.5,49
2016,12,DEN,KC,27,30,-3,0,0,-3.5,3.5,39.5,57
2016,12,NO,LARM,49,21,28,1,1,-7,7,45.5,70
2016,12,DET,MIN,16,13,3,1,1,-2.5,2.5,42.5,29
2016,12,NYJ,NE,17,22,-5,0,1,8.5,-8.5,47,39
2016,12,CLE,NYG,13,27,-14,0,0,7,-7,44.5,40
2016,12,IND,PIT,7,28,-21,0,0,2.5,-2.5,53.5,35
2016,12,HOU,SD,13,21,-8,0,0,0,0,47,34
2016,12,TB,SEA,14,5,9,1,1,5,-5,44.5,19
2016,12,MIA,SF,31,24,7,1,0,-7.5,7.5,45.5,55
2016,12,CHI,TEN,21,27,-6,0,0,2,-2,44.5,48
2016,12,DAL,WAS,31,26,5,1,0,-7,7,48.5,57
2016,13,OAK,BUF,38,24,14,1,1,-3.5,3.5,49.5,62
2016,13,SEA,CAR,40,7,33,1,1,-6.5,6.5,45,47
2016,13,MIN,DAL,15,17,-2,0,1,2.5,-2.5,44,32
2016,13,JAC,DEN,10,20,-10,0,0,4.5,-4.5,43,30
2016,13,NO,DET,13,28,-15,0,0,-4,4,53.5,41
2016,13,GB,HOU,21,13,8,1,1,-6.5,6.5,45.5,34
2016,13,NYJ,IND,10,41,-31,0,0,2,-2,49,51
2016,13,ATL,KC,28,29,-1,0,0,-3.5,3.5,49,57
2016,13,NE,LARM,26,10,16,1,1,-13.5,13.5,45.5,36
2016,13,BAL,MIA,38,6,32,1,1,-3.5,3.5,41.5,44
2016,13,PIT,NYG,24,14,10,1,1,-5.5,5.5,50,38
2016,13,CIN,PHI,32,14,18,1,1,1,-1,42,46
2016,13,CHI,SF,26,6,20,1,1,-2.5,2.5,42.5,32
2016,13,SD,TB,21,28,-7,0,0,-3.5,3.5,46.5,49
2016,13,ARI,WAS,31,23,8,1,1,-2.5,2.5,49.5,54
2016,14,MIA,ARI,26,23,3,1,1,-2.5,2.5,43.5,49
2016,14,LARM,ATL,14,42,-28,0,0,4.5,-4.5,46,56
2016,14,NE,BAL,30,23,7,1,0,-7.5,7.5,44.5,53
2016,14,DET,CHI,20,17,3,1,0,-7.5,7.5,43.5,37
2016,14,CLE,CIN,10,23,-13,0,0,4,-4,43,33
2016,14,NYG,DAL,10,7,3,1,1,3,-3,47.5,17
2016,14,TEN,DEN,13,10,3,1,1,-1.5,1.5,43.5,23
2016,14,IND,HOU,17,22,-5,0,0,-6,6,47,39
2016,14,JAC,MIN,16,25,-9,0,0,3,-3,40,41
2016,14,TB,NO,16,11,5,1,1,-2.5,2.5,51,27
2016,14,SF,NYJ,17,23,-6,0,0,-1,1,44.5,40
2016,14,KC,OAK,21,13,8,1,1,-3,3,46.5,34
2016,14,BUF,PIT,20,27,-7,0,0,2,-2,47.5,47
2016,14,CAR,SD,28,16,12,1,1,-1,1,49,44
2016,14,GB,SEA,38,10,28,1,1,2.5,-2.5,46.5,48
2016,14,PHI,WAS,22,27,-5,0,0,1,-1,46.5,49
2016,15,WAS,CAR,15,26,-11,0,0,-4.5,4.5,51,41
2016,15,BUF,CLE,33,13,20,1,1,-10.5,10.5,43,46
2016,15,NYG,DET,17,6,11,1,1,-4,4,43,23
2016,15,CHI,GB,27,30,-3,0,1,6.5,-6.5,40.5,57
2016,15,MIN,IND,6,34,-28,0,0,-3.5,3.5,45.5,40
2016,15,HOU,JAC,21,20,1,1,0,-5,5,40.5,41
2016,15,SEA,LARM,24,3,21,1,1,-14,14,39.5,27
2016,15,NYJ,MIA,13,34,-21,0,0,3,-3,40.5,47
2016,15,DEN,NE,3,16,-13,0,0,3,-3,44,19
2016,15,ARI,NO,41,48,-7,0,0,-2.5,2.5,50,89
2016,15,SD,OAK,16,19,-3,0,0,3,-3,50,35
2016,15,BAL,PHI,27,26,1,1,0,-6,6,41.5,53
2016,15,CIN,PIT,20,24,-4,0,0,3,-3,44.5,44
2016,15,ATL,SF,41,13,28,1,1,-13,13,52,54
2016,15,DAL,TB,26,20,6,1,0,-7,7,46,46
2016,15,KC,TEN,17,19,-2,0,0,-5,5,43,36
2016,16,SEA,ARI,31,34,-3,0,0,-7.5,7.5,43.5,65
2016,16,CAR,ATL,16,33,-17,0,0,2,-2,51.5,49
2016,16,PIT,BAL,31,27,4,1,0,-4,4,44.5,58
2016,16,HOU,CIN,12,10,2,1,0,-2.5,2.5,41.5,22
2016,16,KC,DEN,33,10,23,1,1,-4,4,38,43
2016,16,DAL,DET,42,21,21,1,1,-7.5,7.5,41.5,63
2016,16,OAK,IND,33,25,8,1,1,-4,4,53,58
2016,16,BUF,MIA,31,34,-3,0,0,-3.5,3.5,42,65
2016,16,GB,MIN,38,25,13,1,1,-7,7,43.5,63
2016,16,PHI,NYG,24,19,5,1,1,3,-3,42,43
2016,16,NE,NYJ,41,3,38,1,1,-16.5,16.5,43.5,44
2016,16,CLE,SD,20,17,3,1,1,6,-6,44,37
2016,16,LARM,SF,21,22,-1,0,0,-3,3,41,43
2016,16,NO,TB,31,24,7,1,1,-3,3,52.5,55
2016,16,JAC,TEN,38,17,21,1,1,4.5,-4.5,43.5,55
2016,16,CHI,WAS,21,41,-20,0,0,3,-3,45,62
2016,17,LARM,ARI,6,44,-38,0,0,7,-7,40.5,50
2016,17,CIN,BAL,27,10,17,1,1,-2.5,2.5,41,37
2016,17,NYJ,BUF,30,10,20,1,1,6,-6,44,40
2016,17,TB,CAR,17,16,1,1,0,-4,4,47.5,33
2016,17,MIN,CHI,38,10,28,1,1,-6.5,6.5,41,48
2016,17,PIT,CLE,27,24,3,1,0,-10,10,44.5,51
2016,17,PHI,DAL,27,13,14,1,1,-3.5,3.5,43,40
2016,17,DET,GB,24,31,-7,0,0,3.5,-3.5,48,55
2016,17,TEN,HOU,24,17,7,1,1,-3,3,40.5,41
2016,17,IND,JAC,24,20,4,1,0,-6,6,48,44
2016,17,SD,KC,27,37,-10,0,0,4,-4,45,64
2016,17,MIA,NE,14,35,-21,0,0,7.5,-7.5,44.5,49
2016,17,ATL,NO,38,32,6,1,0,-7,7,55.5,70
2016,17,WAS,NYG,10,19,-9,0,0,-8,8,44,29
2016,17,DEN,OAK,24,6,18,1,1,-3.5,3.5,41.5,30
2016,17,SF,SEA,23,25,-2,0,1,9.5,-9.5,44,48
2017,1,DET,ARI,35,23,12,1,1,-1,1,48,58
2017,1,CHI,ATL,17,23,-6,0,1,7,-7,50.5,40
2017,1,CIN,BAL,0,20,-20,0,0,-3,3,42.5,20
2017,1,SF,CAR,3,23,-20,0,0,6,-6,48,26
2017,1,LARM,IND,46,9,37,1,1,-3,3,42,55
2017,1,HOU,JAC,7,29,-22,0,0,-4.5,4.5,40.5,36
2017,1,NE,KC,27,42,-15,0,0,-8,8,48,69
2017,1,MIN,NO,29,19,10,1,1,-3.5,3.5,48,48
2017,1,DAL,NYG,19,3,16,1,1,-3.5,3.5,48.5,22
2017,1,BUF,NYJ,21,12,9,1,1,-7,7,42,33
2017,1,TEN,OAK,16,26,-10,0,0,-1,1,51.5,42
2017,1,WAS,PHI,17,30,-13,0,0,-1,1,48,47
2017,1,CLE,PIT,18,21,-3,0,1,9,-9,47,39
2017,1,DEN,SD,24,21,3,1,0,-3.5,3.5,44,45
2017,1,GB,SEA,17,9,8,1,1,-3,3,49.5,26
2017,2,IND,ARI,13,16,-3,0,1,7,-7,44,29
2017,2,CAR,BUF,9,3,6,1,0,-7,7,42.5,12
2017,2,TB,CHI,29,7,22,1,1,-6.5,6.5,43,36
2017,2,BAL,CLE,24,10,14,1,1,-7.5,7.5,41,34
2017,2,DEN,DAL,42,17,25,1,1,2,-2,43,59
2017,2,NYG,DET,10,24,-14,0,0,-4.5,4.5,43.5,34
2017,2,ATL,GB,34,23,11,1,1,-2,2,53.5,57
2017,2,CIN,HOU,9,13,-4,0,0,-3,3,38.5,22
2017,2,SD,MIA,17,19,-2,0,0,-5,5,45,36
2017,2,PIT,MIN,26,9,17,1,1,-7,7,45,35
2017,2,NO,NE,20,36,-16,0,0,4.5,-4.5,54,56
2017,2,OAK,NYJ,45,20,25,1,1,-14,14,43.5,65
2017,2,KC,PHI,27,20,7,1,1,-4.5,4.5,47.5,47
2017,2,SEA,SF,12,9,3,1,0,-12,12,43,21
2017,2,JAC,TEN,16,37,-21,0,0,0,0,44,53
2017,2,LARM,WAS,20,27,-7,0,0,-3,3,46,47
2017,3,DET,ATL,26,30,-4,0,0,3,-3,48.5,56
2017,3,JAC,BAL,44,7,37,1,1,4,-4,40.5,51
2017,3,GB,CIN,27,24,3,1,0,-10,10,44.5,51
2017,3,IND,CLE,31,28,3,1,1,1,-1,40.5,59
2017,3,ARI,DAL,17,28,-11,0,0,3.5,-3.5,47.5,45
2017,3,BUF,DEN,26,16,10,1,1,2,-2,41,42
2017,3,NE,HOU,36,33,3,1,0,-13,13,43.5,69
2017,3,SD,KC,10,24,-14,0,0,2.5,-2.5,45.5,34
2017,3,SF,LARM,39,41,-2,0,1,2.5,-2.5,41,80
2017,3,NYJ,MIA,20,6,14,1,1,6,-6,41.5,26
2017,3,CAR,NO,13,34,-21,0,0,-6,6,49,47
2017,3,PHI,NYG,27,24,3,1,0,-5,5,43.5,51
2017,3,WAS,OAK,27,10,17,1,1,3.5,-3.5,53,37
2017,3,CHI,PIT,23,17,6,1,1,7.5,-7.5,45.5,40
2017,3,TEN,SEA,33,27,6,1,1,-2.5,2.5,43,60
2017,3,MIN,TB,34,17,17,1,1,2.5,-2.5,39.5,51
2017,4,ATL,BUF,17,23,-6,0,0,-8,8,48.5,40
2017,4,NE,CAR,30,33,-3,0,0,-8.5,8.5,48,63
2017,4,GB,CHI,35,14,21,1,1,-7.5,7.5,45.5,49
2017,4,CLE,CIN,7,31,-24,0,0,3.5,-3.5,40,38
2017,4,MIN,DET,7,14,-7,0,0,-1.5,1.5,42.5,21
2017,4,SEA,IND,46,18,28,1,1,-13.5,13.5,41.5,64
2017,4,NYJ,JAC,23,20,3,1,1,3.5,-3.5,39.5,43
2017,4,DAL,LARM,30,35,-5,0,0,-7.5,7.5,46.5,65
2017,4,MIA,NO,0,20,-20,0,0,2.5,-2.5,50,20
2017,4,TB,NYG,25,23,2,1,0,-4,4,44,48
2017,4,DEN,OAK,16,10,6,1,1,-2.5,2.5,46.5,26
2017,4,SD,PHI,24,26,-2,0,0,-1,1,46.5,50
2017,4,BAL,PIT,9,26,-17,0,0,2.5,-2.5,45,35
2017,4,ARI,SF,18,15,3,1,0,-7,7,44.5,33
2017,4,HOU,TEN,57,14,43,1,1,1.5,-1.5,43.5,71
2017,4,KC,WAS,29,20,9,1,1,-7,7,49.5,49
2017,5,PHI,ARI,34,7,27,1,1,-6,6,45,41
2017,5,OAK,BAL,17,30,-13,0,0,-2.5,2.5,40,47
2017,5,CIN,BUF,20,16,4,1,1,-3,3,39,36
2017,5,DET,CAR,24,27,-3,0,0,-3,3,43.5,51
2017,5,DAL,GB,31,35,-4,0,0,-2.5,2.5,52.5,66
2017,5,PIT,JAC,9,30,-21,0,0,-8.5,8.5,44.5,39
2017,5,HOU,KC,34,42,-8,0,0,0,0,47,76
2017,5,CHI,MIN,17,20,-3,0,0,2,-2,40.5,37
2017,5,TB,NE,14,19,-5,0,0,4.5,-4.5,54,33
2017,5,CLE,NYJ,14,17,-3,0,0,-1.5,1.5,39,31
2017,5,NYG,SD,22,27,-5,0,0,-4.5,4.5,44.5,49
2017,5,LARM,SEA,10,16,-6,0,0,-2.5,2.5,46,26
2017,5,IND,SF,26,23,3,1,1,-1.5,1.5,43,49
2017,5,MIA,TEN,16,10,6,1,1,3,-3,43.5,26
2017,6,BAL,CHI,24,27,-3,0,0,-6.5,6.5,39.5,51
2017,6,HOU,CLE,33,17,16,1,1,-9.5,9.5,44,50
2017,6,NO,DET,52,38,14,1,1,-3.5,3.5,50.5,90
2017,6,MIN,GB,23,10,13,1,1,3,-3,46.5,33
2017,6,TEN,IND,36,22,14,1,1,-8,8,48,58
2017,6,JAC,LARM,17,27,-10,0,0,-2.5,2.5,44,44
2017,6,ATL,MIA,17,20,-3,0,0,-10,10,48,37
2017,6,NYJ,NE,17,24,-7,0,1,9.5,-9.5,47.5,41
2017,6,DEN,NYG,10,23,-13,0,0,-10,10,40.5,33
2017,6,CAR,PHI,23,28,-5,0,0,-3,3,45,51
2017,6,KC,PIT,13,19,-6,0,0,-4,4,46,32
2017,6,OAK,SD,16,17,-1,0,0,-3.5,3.5,50.5,33
2017,6,WAS,SF,26,24,2,1,0,-10,10,46.5,50
2017,6,ARI,TB,38,33,5,1,1,2,-2,44,71
2017,7,LARM,ARI,33,0,33,1,1,-3.5,3.5,47,33
2017,7,NE,ATL,23,7,16,1,1,-4.5,4.5,54,30
2017,7,MIN,BAL,24,16,8,1,1,-4.5,4.5,39.5,40
2017,7,CHI,CAR,17,3,14,1,1,3.5,-3.5,41.5,20
2017,7,PIT,CIN,29,14,15,1,1,-6,6,42,43
2017,7,SF,DAL,10,40,-30,0,0,6,-6,47,50
2017,7,SD,DEN,21,0,21,1,1,-1,1,41.5,21
2017,7,IND,JAC,0,27,-27,0,0,3,-3,43.5,27
2017,7,OAK,KC,31,30,1,1,1,3,-3,47.5,61
2017,7,GB,NO,17,26,-9,0,0,4.5,-4.5,47.5,43
2017,7,MIA,NYJ,31,28,3,1,0,-4,4,39,59
2017,7,NYG,SEA,7,24,-17,0,0,8,-8,38.5,31
2017,7,BUF,TB,30,27,3,1,0,-3,3,44,57
2017,7,CLE,TEN,9,12,-3,0,1,5.5,-5.5,46.5,21
2017,7,PHI,WAS,34,24,10,1,1,-5.5,5.5,48.5,58
2017,8,NYJ,ATL,20,25,-5,0,0,4.5,-4.5,46.5,45
2017,8,TB,CAR,3,17,-14,0,0,-2.5,2.5,44,20
2017,8,NO,CHI,20,12,8,1,0,-9,9,48,32
2017,8,WAS,DAL,19,33,-14,0,0,0,0,50.5,52
2017,8,KC,DEN,29,19,10,1,1,-7.5,7.5,42,48
2017,8,SEA,HOU,41,38,3,1,0,-5.5,5.5,42,79
2017,8,CIN,IND,24,23,1,1,0,-10,10,41,47
2017,8,BAL,MIA,40,0,40,1,1,-3,3,37.5,40
2017,8,CLE,MIN,16,33,-17,0,0,8.5,-8.5,37.5,49
2017,8,BUF,OAK,34,14,20,1,1,-3,3,46,48
2017,8,DET,PIT,15,20,-5,0,0,3,-3,45,35
2017,8,NE,SD,21,13,8,1,1,-7,7,49,34
2017,8,PHI,SF,33,10,23,1,1,-13,13,47.5,43
2017,9,SF,ARI,10,20,-10,0,0,2.5,-2.5,39,30
2017,9,CAR,ATL,20,17,3,1,1,-2,2,44,37
2017,9,TEN,BAL,23,20,3,1,0,-3.5,3.5,43,43
2017,9,NYJ,BUF,34,21,13,1,1,3.5,-3.5,42,55
2017,9,JAC,CIN,23,7,16,1,1,-3.5,3.5,39.5,30
2017,9,PHI,DEN,51,23,28,1,1,-7.5,7.5,43.5,74
2017,9,GB,DET,17,30,-13,0,0,2.5,-2.5,43,47
2017,9,HOU,IND,14,20,-6,0,0,-13,13,48,34
2017,9,DAL,KC,28,17,11,1,1,0,0,51,45
2017,9,NYG,LARM,17,51,-34,0,0,3.5,-3.5,43.5,68
2017,9,MIA,OAK,24,27,-3,0,0,2.5,-2.5,43.5,51
2017,9,NO,TB,30,10,20,1,1,-7,7,50,40
2017,9,SEA,WAS,14,17,-3,0,0,-7,7,45,31
2017,10,TEN,CIN,24,20,4,1,0,-5.5,5.5,40.5,44
2017,10,DET,CLE,38,24,14,1,1,-13,13,43.5,62
2017,10,ATL,DAL,27,7,20,1,1,-3,3,50.5,34
2017,10,CHI,GB,16,23,-7,0,0,-4.5,4.5,38,39
2017,10,LARM,HOU,33,7,26,1,1,-11.5,11.5,47,40
2017,10,CAR,MIA,45,21,24,1,1,-10,10,39.5,66
2017,10,WAS,MIN,30,38,-8,0,0,2,-2,42.5,68
2017,10,DEN,NE,16,41,-25,0,0,7.5,-7.5,46,57
2017,10,BUF,NO,10,47,-37,0,0,2,-2,48.5,57
2017,10,SF,NYG,31,21,10,1,1,-1,1,42,52
2017,10,TB,NYJ,15,10,5,1,1,2.5,-2.5,41,25
2017,10,IND,PIT,17,20,-3,0,1,10.5,-10.5,43,37
2017,10,JAC,SD,20,17,3,1,0,-4,4,41.5,37
2017,10,ARI,SEA,16,22,-6,0,0,6,-6,42.5,38
2017,11,HOU,ARI,31,21,10,1,1,0,0,38.5,52
2017,11,SEA,ATL,31,34,-3,0,0,-3,3,45,65
2017,11,GB,BAL,0,23,-23,0,0,2,-2,38.5,23
2017,11,SD,BUF,54,24,30,1,1,-4.5,4.5,43.5,78
2017,11,DEN,CIN,17,20,-3,0,0,-2.5,2.5,40,37
2017,11,CHI,DET,24,27,-3,0,0,3,-3,44,51
2017,11,CLE,JAC,7,19,-12,0,0,7.5,-7.5,38,26
2017,11,NYG,KC,12,9,3,1,1,11,-11,43.5,21
2017,11,MIN,LARM,24,7,17,1,1,-2.5,2.5,46,31
2017,11,OAK,NE,8,33,-25,0,0,5.5,-5.5,50,41
2017,11,DAL,PHI,9,37,-28,0,0,3.5,-3.5,47,46
2017,11,MIA,TB,20,30,-10,0,0,0,0,40,50
2017,11,PIT,TEN,40,17,23,1,1,-7,7,44,57
2017,11,NO,WAS,34,31,3,1,0,-7.5,7.5,50,65
2017,12,KC,BUF,10,16,-6,0,0,-9.5,9.5,45,26
2017,12,NYJ,CAR,27,35,-8,0,0,4.5,-4.5,39.5,62
2017,12,PHI,CHI,31,3,28,1,1,-13.5,13.5,44,34
2017,12,CIN,CLE,30,16,14,1,1,-8,8,38,46
2017,12,OAK,DEN,21,14,7,1,1,-5,5,43,35
2017,12,PIT,GB,31,28,3,1,0,-13.5,13.5,41.5,59
2017,12,BAL,HOU,23,16,7,1,0,-7.5,7.5,38,39
2017,12,ARI,JAC,27,24,3,1,1,4,-4,38,51
2017,12,NE,MIA,35,17,18,1,1,-17,17,47.5,52
2017,12,DET,MIN,23,30,-7,0,0,-1,1,44.5,53
2017,12,LARM,NO,26,20,6,1,1,-2.5,2.5,54,46
2017,12,WAS,NYG,20,10,10,1,1,-7.5,7.5,44.5,30
2017,12,DAL,SD,6,28,-22,0,0,-2.5,2.5,48,34
2017,12,SF,SEA,13,24,-11,0,0,7,-7,42,37
2017,12,ATL,TB,34,20,14,1,1,-10,10,49,54
2017,12,IND,TEN,16,20,-4,0,1,4.5,-4.5,44,36
2017,13,NO,CAR,31,21,10,1,1,-4,4,48,52
2017,13,SD,CLE,19,10,9,1,0,-13,13,42.5,29
2017,13,MIA,DEN,35,9,26,1,1,1,-1,38,44
2017,13,BAL,DET,44,20,24,1,1,-3,3,40,64
2017,13,TEN,HOU,24,13,11,1,1,-7.5,7.5,42,37
2017,13,JAC,IND,30,10,20,1,1,-8.5,8.5,40.5,40
2017,13,NYJ,KC,38,31,7,1,1,4,-4,43.5,69
2017,13,ARI,LARM,16,32,-16,0,0,6.5,-6.5,45.5,48
2017,13,ATL,MIN,9,14,-5,0,0,-3,3,47,23
2017,13,BUF,NE,3,23,-20,0,0,7.5,-7.5,49.5,26
2017,13,OAK,NYG,24,17,7,1,0,-7.5,7.5,40.5,41
2017,13,SEA,PHI,24,10,14,1,1,3.5,-3.5,48,34
2017,13,CIN,PIT,20,23,-3,0,1,6,-6,43.5,43
2017,13,CHI,SF,14,15,-1,0,0,-4,4,39.5,29
2017,13,GB,TB,26,20,6,1,1,1.5,-1.5,44,46
2017,13,DAL,WAS,38,14,24,1,1,-1.5,1.5,44.5,52
2017,14,PIT,BAL,39,38,1,1,0,-6,6,43.5,77
2017,14,CIN,CHI,7,33,-26,0,0,-6,6,37,40
2017,14,NYG,DAL,10,30,-20,0,0,6,-6,41,40
2017,14,TB,DET,21,24,-3,0,0,2,-2,43,45
2017,14,CLE,GB,21,27,-6,0,0,4,-4,41,48
2017,14,BUF,IND,13,7,6,1,1,-3.5,3.5,39.5,20
2017,14,CAR,MIN,31,24,7,1,1,2,-2,42,55
2017,14,MIA,NE,27,20,7,1,1,12,-12,48.5,47
2017,14,ATL,NO,20,17,3,1,1,-1.5,1.5,54.5,37
2017,14,DEN,NYJ,23,0,23,1,1,1,-1,40.5,23
2017,14,KC,OAK,26,15,11,1,1,-4,4,47.5,41
2017,14,LARM,PHI,35,43,-8,0,0,-1,1,51,78
2017,14,JAC,SEA,30,24,6,1,1,-3,3,39,54
2017,14,HOU,SF,16,26,-10,0,0,-1.5,1.5,42.5,42
2017,14,ARI,TEN,12,7,5,1,1,3,-3,44.5,19
2017,14,SD,WAS,30,13,17,1,1,-6.5,6.5,46,43
2017,15,WAS,ARI,20,15,5,1,1,-4,4,44,35
2017,15,TB,ATL,21,24,-3,0,1,6,-6,47.5,45
2017,15,CLE,BAL,10,27,-17,0,0,7.5,-7.5,40,37
2017,15,DET,CHI,20,10,10,1,1,-6.5,6.5,43.5,30
2017,15,MIN,CIN,34,7,27,1,1,-11.5,11.5,41,41
2017,15,OAK,DAL,17,20,-3,0,0,2.5,-2.5,46,37
2017,15,IND,DEN,13,25,-12,0,0,1.5,-1.5,41,38
2017,15,CAR,GB,31,24,7,1,1,-3,3,45.5,55
2017,15,JAC,HOU,45,7,38,1,1,-11,11,39.5,52
2017,15,SEA,LARM,7,42,-35,0,0,0,0,47.5,49
2017,15,BUF,MIA,24,16,8,1,1,-3.5,3.5,39,40
2017,15,PIT,NE,24,27,-3,0,0,2,-2,53,51
2017,15,NO,NYJ,31,19,12,1,0,-14.5,14.5,47,50
2017,15,NYG,PHI,29,34,-5,0,1,7.5,-7.5,40,63
2017,15,KC,SD,30,13,17,1,1,0,0,45.5,43
2017,15,SF,TEN,25,23,2,1,0,-2,2,45,48
2017,16,NO,ATL,23,13,10,1,1,-5.5,5.5,52.5,36
2017,16,NE,BUF,37,16,21,1,1,-12.5,12.5,47,53
2017,16,CHI,CLE,20,3,17,1,1,-7,7,38,23
2017,16,WAS,DEN,27,11,16,1,1,-4,4,41,38
2017,16,CIN,DET,26,17,9,1,1,4,-4,43,43
2017,16,BAL,IND,23,16,7,1,0,-13.5,13.5,41.5,39
2017,16,SF,JAC,44,33,11,1,1,4.5,-4.5,42.5,77
2017,16,TEN,LARM,23,27,-4,0,1,6.5,-6.5,49,50
2017,16,KC,MIA,29,13,16,1,1,-10,10,45,42
2017,16,GB,MIN,0,16,-16,0,0,9,-9,40.5,16
2017,16,ARI,NYG,23,0,23,1,1,-4.5,4.5,40,23
2017,16,PHI,OAK,19,10,9,1,0,-9,9,48.5,29
2017,16,HOU,PIT,6,34,-28,0,0,10,-10,44,40
2017,16,NYJ,SD,7,14,-7,0,1,7.5,-7.5,42.5,21
2017,16,DAL,SEA,12,21,-9,0,0,-4.5,4.5,47,33
2017,16,CAR,TB,22,19,3,1,0,-10,10,46.5,41
2017,17,SEA,ARI,24,26,-2,0,0,-7.5,7.5,40.5,50
2017,17,MIA,BUF,16,22,-6,0,0,3,-3,42.5,38
2017,17,ATL,CAR,22,10,12,1,1,-3.5,3.5,47,32
2017,17,MIN,CHI,23,10,13,1,1,-12.5,12.5,39.5,33
2017,17,BAL,CIN,27,31,-4,0,0,-10,10,40.5,58
2017,17,PIT,CLE,28,24,4,1,0,-16,16,41,52
2017,17,PHI,DAL,0,6,-6,0,0,0,0,43,6
2017,17,DET,GB,35,11,24,1,1,-7.5,7.5,42.5,46
2017,17,IND,HOU,22,13,9,1,1,0,0,43,35
2017,17,TEN,JAC,15,10,5,1,0,-6,6,41,25
2017,17,DEN,KC,24,27,-3,0,0,-3.5,3.5,39,51
2017,17,TB,NO,31,24,7,1,1,7.5,-7.5,50.5,55
2017,17,NE,NYJ,26,6,20,1,1,-16.5,16.5,46,32
2017,17,SD,OAK,30,10,20,1,1,-9,9,43.5,40
2017,17,LARM,SF,13,34,-21,0,0,-6.5,6.5,44,47
2017,17,NYG,WAS,18,10,8,1,1,3.5,-3.5,38.5,28
2018,1,PHI,ATL,18,12,6,1,1,-4,4,46,30
2018,1,BAL,BUF,47,3,44,1,1,-6,6,41,50
2018,1,GB,CHI,24,23,1,1,0,-8,8,47.5,47
2018,1,IND,CIN,23,34,-11,0,0,-3,3,46,57
2018,1,CAR,DAL,16,8,8,1,1,-2.5,2.5,44,24
2018,1,NE,HOU,27,20,7,1,1,-6.5,6.5,51,47
2018,1,NYG,JAC,15,20,-5,0,0,3,-3,43.5,35
2018,1,SD,KC,28,38,-10,0,0,-3,3,47,66
2018,1,OAK,LARM,13,33,-20,0,0,3,-3,49.5,46
2018,1,DET,NYJ,17,48,-31,0,0,-6.5,6.5,44,65
2018,1,CLE,PIT,21,21,0,0,1,5.5,-5.5,46.5,42
2018,1,DEN,SEA,27,24,3,1,1,-2.5,2.5,42,51
2018,1,MIN,SF,24,16,8,1,1,-5.5,5.5,46,40
2018,1,NO,TB,40,48,-8,0,0,-9.5,9.5,49.5,88
2018,1,MIA,TEN,27,20,7,1,1,1.5,-1.5,45,47
2018,1,ARI,WAS,6,24,-18,0,0,-1,1,44,30
2018,2,LARM,ARI,34,0,34,1,1,-13,13,46.5,34
2018,2,CIN,BAL,34,23,11,1,1,1,-1,44,57
2018,2,ATL,CAR,31,24,7,1,1,-4.5,4.5,44,55
2018,2,NO,CLE,21,18,3,1,0,-8,8,49.5,39
2018,2,SF,DET,30,27,3,1,0,-5.5,5.5,47.5,57
2018,2,TEN,HOU,20,17,3,1,1,2,-2,45,37
2018,2,WAS,IND,9,21,-12,0,0,-5.5,5.5,47.5,30
2018,2,PIT,KC,37,42,-5,0,0,-4.5,4.5,49.5,79
2018,2,NYJ,MIA,12,20,-8,0,0,-3,3,44,32
2018,2,GB,MIN,29,29,0,0,0,-1.5,1.5,46.5,58
2018,2,JAC,NE,31,20,11,1,1,2.5,-2.5,45,51
2018,2,DAL,NYG,20,13,7,1,1,-3,3,44,33
2018,2,DEN,OAK,20,19,1,1,0,-6,6,45,39
2018,2,TB,PHI,27,21,6,1,1,3,-3,44,48
2018,2,BUF,SD,20,31,-11,0,0,7.5,-7.5,44,51
2018,2,CHI,SEA,24,17,7,1,1,-3.5,3.5,43.5,41
2018,3,MIN,BUF,6,27,-21,0,0,-16.5,16.5,40.5,33
2018,3,ARI,CHI,14,16,-2,0,1,6,-6,37.5,30
2018,3,CAR,CIN,31,21,10,1,1,-3,3,43.5,52
2018,3,SEA,DAL,24,13,11,1,1,-1,1,41.5,37
2018,3,BAL,DEN,27,14,13,1,1,-4.5,4.5,43.5,41
2018,3,WAS,GB,31,17,14,1,1,3,-3,47.5,48
2018,3,PHI,IND,20,16,4,1,0,-6.5,6.5,47.5,36
2018,3,DET,NE,26,10,16,1,1,6.5,-6.5,50,36
2018,3,ATL,NO,37,43,-6,0,0,-3,3,53,80
2018,3,HOU,NYG,22,27,-5,0,0,-6,6,41.5,49
2018,3,CLE,NYJ,21,17,4,1,1,-3,3,39.5,38
2018,3,MIA,OAK,28,20,8,1,1,-3,3,43.5,48
2018,3,TB,PIT,27,30,-3,0,0,2.5,-2.5,52,57
2018,3,LARM,SD,35,23,12,1,1,-6.5,6.5,48,58
2018,3,KC,SF,38,27,11,1,1,-6,6,55,65
2018,3,JAC,TEN,6,9,-3,0,0,-10,10,40,15
2018,4,PIT,BAL,14,26,-12,0,0,-3.5,3.5,51,40
2018,4,GB,BUF,22,0,22,1,1,-10.5,10.5,44.5,22
2018,4,ATL,CIN,36,37,-1,0,0,-5.5,5.5,48,73
2018,4,OAK,CLE,45,42,3,1,1,-2.5,2.5,44.5,87
2018,4,DAL,DET,26,24,2,1,0,-3,3,44,50
2018,4,IND,HOU,34,37,-3,0,0,-2.5,2.5,47,71
2018,4,DEN,KC,23,27,-4,0,0,4,-4,55,50
2018,4,NE,MIA,38,7,31,1,1,-7,7,48,45
2018,4,LARM,MIN,38,31,7,1,0,-7,7,48,69
2018,4,NYG,NO,18,33,-15,0,0,3.5,-3.5,50,51
2018,4,JAC,NYJ,31,12,19,1,1,-8.5,8.5,38,43
2018,4,TEN,PHI,26,23,3,1,1,3,-3,42,49
2018,4,ARI,SEA,17,20,-3,0,0,3,-3,37.5,37
2018,4,SD,SF,29,27,2,1,0,-9.5,9.5,47,56
2018,4,CHI,TB,48,10,38,1,1,-3,3,46.5,58
2018,5,SF,ARI,18,28,-10,0,0,-5.5,5.5,41,46
2018,5,PIT,ATL,41,17,24,1,1,-3,3,56.5,58
2018,5,CLE,BAL,12,9,3,1,1,3,-3,47,21
2018,5,HOU,DAL,19,16,3,1,0,-3,3,45,35
2018,5,NYJ,DEN,34,16,18,1,1,-2.5,2.5,43,50
2018,5,DET,GB,31,23,8,1,1,1,-1,51,54
2018,5,NE,IND,38,24,14,1,1,-10,10,53,62
2018,5,KC,JAC,30,14,16,1,1,-3,3,48.5,44
2018,5,SEA,LARM,31,33,-2,0,1,7,-7,49,64
2018,5,CIN,MIA,27,17,10,1,1,-5.5,5.5,50,44
2018,5,PHI,MIN,21,23,-2,0,0,-3,3,44.5,44
2018,5,CAR,NYG,33,31,2,1,0,-6,6,44,64
2018,5,SD,OAK,26,10,16,1,1,-6.5,6.5,51.5,36
2018,5,BUF,TEN,13,12,1,1,1,3,-3,39.5,25
2018,5,NO,WAS,43,19,24,1,1,-6.5,6.5,51.5,62
2018,6,MIN,ARI,27,17,10,1,0,-10.5,10.5,43,44
2018,6,TEN,BAL,0,21,-21,0,0,1.5,-1.5,42,21
2018,6,HOU,BUF,20,13,7,1,0,-9.5,9.5,41,33
2018,6,WAS,CAR,23,17,6,1,1,-1,1,45,40
2018,6,MIA,CHI,31,28,3,1,1,3,-3,44,59
2018,6,NYJ,IND,42,34,8,1,1,-3,3,45.5,76
2018,6,DAL,JAC,40,7,33,1,1,3,-3,41,47
2018,6,NE,KC,43,40,3,1,0,-3,3,58.5,83
2018,6,DEN,LARM,20,23,-3,0,1,7,-7,52.5,43
2018,6,NYG,PHI,13,34,-21,0,0,2.5,-2.5,45,47
2018,6,CIN,PIT,21,28,-7,0,0,-2.5,2.5,54.5,49
2018,6,CLE,SD,14,38,-24,0,0,1.5,-1.5,46,52
2018,6,OAK,SEA,3,27,-24,0,0,3,-3,47,30
2018,6,GB,SF,33,30,3,1,0,-9.5,9.5,46.5,63
2018,6,ATL,TB,34,29,5,1,1,-3.5,3.5,57.5,63
2018,7,IND,BUF,37,5,32,1,1,-7.5,7.5,43.5,42
2018,7,PHI,CAR,17,21,-4,0,0,-3.5,3.5,45,38
2018,7,KC,CIN,45,10,35,1,1,-5.5,5.5,58.5,55
2018,7,TB,CLE,26,23,3,1,0,-3,3,49,49
2018,7,WAS,DAL,20,17,3,1,1,-2,2,42,37
2018,7,ARI,DEN,10,45,-35,0,0,1.5,-1.5,40,55
2018,7,MIA,DET,21,32,-11,0,0,3,-3,46.5,53
2018,7,JAC,HOU,7,20,-13,0,0,-4,4,43,27
2018,7,SF,LARM,10,39,-29,0,0,10,-10,52.5,49
2018,7,NYJ,MIN,17,37,-20,0,0,3,-3,47,54
2018,7,CHI,NE,31,38,-7,0,0,2.5,-2.5,50,69
2018,7,BAL,NO,23,24,-1,0,0,-2.5,2.5,50,47
2018,7,ATL,NYG,23,20,3,1,0,-5.5,5.5,54,43
2018,7,SD,TEN,20,19,1,1,0,-6,6,45,39
2018,8,CAR,BAL,36,21,15,1,1,1.5,-1.5,43.5,57
2018,8,PIT,CLE,33,18,15,1,1,-7,7,50.5,51
2018,8,KC,DEN,30,23,7,1,0,-10,10,55.5,53
2018,8,LARM,GB,29,27,2,1,0,-9,9,56.5,56
2018,8,OAK,IND,28,42,-14,0,0,1.5,-1.5,51,70
2018,8,HOU,MIA,42,23,19,1,1,-6.5,6.5,45.5,65
2018,8,BUF,NE,6,25,-19,0,0,13,-13,44.5,31
2018,8,MIN,NO,20,30,-10,0,0,-1.5,1.5,52,50
2018,8,CHI,NYJ,24,10,14,1,1,-7,7,46,34
2018,8,JAC,PHI,18,24,-6,0,0,3,-3,41,42
2018,8,DET,SEA,14,28,-14,0,0,-3,3,49,42
2018,8,ARI,SF,18,15,3,1,1,-1,1,43.5,33
2018,8,CIN,TB,37,34,3,1,0,-6,6,53.5,71
2018,8,NYG,WAS,13,20,-7,0,0,1,-1,42,33
2018,9,WAS,ATL,14,38,-24,0,0,-2,2,47.5,52
2018,9,BUF,CHI,9,41,-32,0,0,8.5,-8.5,37.5,50
2018,9,MIN,DET,24,9,15,1,1,-5,5,51,33
2018,9,NE,GB,31,17,14,1,1,-6.5,6.5,56.5,48
2018,9,DEN,HOU,17,19,-2,0,0,-2.5,2.5,46.5,36
2018,9,CLE,KC,21,37,-16,0,0,8,-8,52,58
2018,9,NO,LARM,45,35,10,1,1,-1,1,59,80
2018,9,MIA,NYJ,13,6,7,1,1,-3,3,45.5,19
2018,9,SF,OAK,34,3,31,1,1,-3,3,47.5,37
2018,9,BAL,PIT,16,23,-7,0,0,-3,3,47.5,39
2018,9,SEA,SD,17,25,-8,0,0,-2,2,48,42
2018,9,CAR,TB,42,28,14,1,1,-6.5,6.5,54,70
2018,9,DAL,TEN,14,28,-14,0,0,-4.5,4.5,42,42
2018,10,KC,ARI,26,14,12,1,0,-16.5,16.5,50,40
2018,10,CLE,ATL,28,16,12,1,1,4,-4,51,44
2018,10,NYJ,BUF,10,41,-31,0,0,-8,8,37,51
2018,10,PIT,CAR,52,21,31,1,1,-5,5,50,73
2018,10,PHI,DAL,20,27,-7,0,0,-6.5,6.5,43.5,47
2018,10,CHI,DET,34,22,12,1,1,-6.5,6.5,45,56
2018,10,IND,JAC,29,26,3,1,0,-3.5,3.5,47.5,55
2018,10,GB,MIA,31,12,19,1,1,-9,9,47.5,43
2018,10,TEN,NE,34,10,24,1,1,7,-7,46.5,44
2018,10,CIN,NO,14,51,-37,0,0,4,-4,55,65
2018,10,SF,NYG,23,27,-4,0,0,-3,3,43.5,50
2018,10,OAK,SD,6,20,-14,0,0,10,-10,50.5,26
2018,10,LARM,SEA,36,31,5,1,0,-10,10,51.5,67
2018,10,TB,WAS,3,16,-13,0,0,-1,1,51.5,19
2018,11,DET,CAR,20,19,1,1,1,3.5,-3.5,52,39
2018,11,BAL,CIN,24,21,3,1,0,-4,4,43.5,45
2018,11,ATL,DAL,19,22,-3,0,0,-3,3,47.5,41
2018,11,SD,DEN,22,23,-1,0,0,-7,7,47,45
2018,11,SEA,GB,27,24,3,1,0,-3,3,49.5,51
2018,11,WAS,HOU,21,23,-2,0,1,2.5,-2.5,43,44
2018,11,LARM,KC,54,51,3,1,1,-2.5,2.5,63.5,105
2018,11,CHI,MIN,25,20,5,1,1,-3,3,45.5,45
2018,11,ARI,OAK,21,23,-2,0,0,-4,4,41,44
2018,11,NO,PHI,48,7,41,1,1,-9,9,54.5,55
2018,11,JAC,PIT,16,20,-4,0,1,5,-5,47.5,36
2018,11,NYG,TB,38,35,3,1,1,-1,1,52.5,73
2018,11,IND,TEN,38,10,28,1,1,-3,3,48,48
2018,12,SD,ARI,45,10,35,1,1,-11,11,44.5,55
2018,12,NO,ATL,31,17,14,1,1,-12.5,12.5,59,48
2018,12,DET,CHI,16,23,-7,0,0,4,-4,45,39
2018,12,CIN,CLE,20,35,-15,0,0,-3,3,47.5,55
2018,12,MIN,GB,24,17,7,1,1,-4,4,48,41
2018,12,BUF,JAC,24,21,3,1,1,3.5,-3.5,38,45
2018,12,IND,MIA,27,24,3,1,0,-10,10,51,51
2018,12,NYJ,NE,13,27,-14,0,0,9.5,-9.5,46.5,40
2018,12,PHI,NYG,25,22,3,1,0,-4.5,4.5,46,47
2018,12,BAL,OAK,34,17,17,1,1,-11.5,11.5,42.5,51
2018,12,DEN,PIT,24,17,7,1,1,3.5,-3.5,47.5,41
2018,12,CAR,SEA,27,30,-3,0,0,-3.5,3.5,47,57
2018,12,TB,SF,27,9,18,1,1,-3.5,3.5,55,36
2018,12,HOU,TEN,34,17,17,1,1,-6,6,41,51
2018,12,DAL,WAS,31,23,8,1,0,-8,8,41,54
2018,13,GB,ARI,17,20,-3,0,0,-14,14,46,37
2018,13,ATL,BAL,16,26,-10,0,0,1.5,-1.5,49,42
2018,13,MIA,BUF,21,17,4,1,0,-6,6,40.5,38
2018,13,TB,CAR,24,17,7,1,1,4,-4,56,41
2018,13,NYG,CHI,30,27,3,1,1,4,-4,44.5,57
2018,13,HOU,CLE,29,13,16,1,1,-6.5,6.5,48,42
2018,13,CIN,DEN,10,24,-14,0,0,3.5,-3.5,42.5,34
2018,13,JAC,IND,6,0,6,1,1,3.5,-3.5,48,6
2018,13,OAK,KC,33,40,-7,0,1,15,-15,56,73
2018,13,DET,LARM,16,30,-14,0,0,9.5,-9.5,54.5,46
2018,13,NE,MIN,24,10,14,1,1,-5.5,5.5,48,34
2018,13,DAL,NO,13,10,3,1,1,7.5,-7.5,53,23
2018,13,TEN,NYJ,26,22,4,1,0,-9,9,40.5,48
2018,13,PIT,SD,30,33,-3,0,0,-3.5,3.5,52.5,63
2018,13,SEA,SF,43,16,27,1,1,-10,10,46,59
2018,13,PHI,WAS,28,13,15,1,1,-7,7,44,41
2018,14,GB,ATL,34,20,14,1,1,-5.5,5.5,47.5,54
2018,14,KC,BAL,27,24,3,1,0,-7,7,53.5,51
2018,14,CLE,CAR,26,20,6,1,1,1,-1,46.5,46
2018,14,SD,CIN,26,21,5,1,0,-14.5,14.5,47,47
2018,14,SF,DEN,20,14,6,1,1,5.5,-5.5,44,34
2018,14,ARI,DET,3,17,-14,0,0,2.5,-2.5,41.5,20
2018,14,HOU,IND,21,24,-3,0,0,-4,4,49.5,45
2018,14,TEN,JAC,30,9,21,1,1,-4.5,4.5,38,39
2018,14,CHI,LARM,15,6,9,1,1,3,-3,54,21
2018,14,SEA,MIN,21,7,14,1,1,-3,3,45,28
2018,14,MIA,NE,34,33,1,1,1,7.5,-7.5,48,67
2018,14,TB,NO,14,28,-14,0,0,8,-8,57.5,42
2018,14,WAS,NYG,16,40,-24,0,0,4,-4,41,56
2018,14,BUF,NYJ,23,27,-4,0,0,-3.5,3.5,38,50
2018,14,DAL,PHI,29,23,6,1,1,-4,4,43.5,52
2018,14,OAK,PIT,24,21,3,1,1,11.5,-11.5,52,45
2018,15,ATL,ARI,40,14,26,1,1,-9,9,44,54
2018,15,DEN,CLE,16,17,-1,0,0,-3.5,3.5,44.5,33
2018,15,IND,DAL,23,0,23,1,1,-2.5,2.5,47,23
2018,15,BUF,DET,14,13,1,1,0,-1.5,1.5,38,27
2018,15,CHI,GB,24,17,7,1,1,-6.5,6.5,46.5,41
2018,15,NYJ,HOU,22,29,-7,0,0,6,-6,42.5,51
2018,15,MIN,MIA,41,17,24,1,1,-7,7,43,58
2018,15,PIT,NE,17,10,7,1,1,1,-1,52,27
2018,15,CAR,NO,9,12,-3,0,1,6.5,-6.5,54,21
2018,15,CIN,OAK,30,16,14,1,1,-3,3,46.5,46
2018,15,LARM,PHI,23,30,-7,0,0,-9.5,9.5,53.5,53
2018,15,KC,SD,28,29,-1,0,0,-3.5,3.5,56.5,57
2018,15,SF,SEA,26,23,3,1,1,6.5,-6.5,44.5,49
2018,15,BAL,TB,20,12,8,1,0,-8,8,47,32
2018,15,NYG,TEN,0,17,-17,0,0,-2.5,2.5,43.5,17
2018,15,JAC,WAS,13,16,-3,0,0,-6.5,6.5,36,29
2018,16,CAR,ATL,10,24,-14,0,0,-3,3,47,34
2018,16,SD,BAL,10,22,-12,0,0,-4.5,4.5,45,32
2018,16,NE,BUF,24,12,12,1,0,-12.5,12.5,45.5,36
2018,16,SF,CHI,9,14,-5,0,0,3.5,-3.5,43,23
2018,16,CLE,CIN,26,18,8,1,1,-6.5,6.5,46,44
2018,16,OAK,DEN,27,14,13,1,1,2.5,-2.5,45,41
2018,16,NYJ,GB,38,44,-6,0,0,2.5,-2.5,45,82
2018,16,PHI,HOU,32,30,2,1,1,1,-1,45,62
2018,16,MIA,JAC,7,17,-10,0,0,-5,5,40,24
2018,16,SEA,KC,38,31,7,1,1,2.5,-2.5,54,69
2018,16,ARI,LARM,9,31,-22,0,0,13.5,-13.5,47.5,40
2018,16,DET,MIN,9,27,-18,0,0,4.5,-4.5,43.5,36
2018,16,IND,NYG,28,27,1,1,0,-9,9,47,55
2018,16,NO,PIT,31,28,3,1,0,-5.5,5.5,53.5,59
2018,16,DAL,TB,27,20,7,1,0,-7,7,46,47
2018,16,TEN,WAS,25,16,9,1,0,-10,10,37,41
2018,17,SEA,ARI,27,24,3,1,0,-13.5,13.5,40,51
2018,17,TB,ATL,32,34,-2,0,0,-1,1,49.5,66
2018,17,NO,CAR,14,33,-19,0,0,-7.5,7.5,45,47
2018,17,MIN,CHI,10,24,-14,0,0,-6,6,41,34
2018,17,PIT,CIN,16,13,3,1,0,-14,14,48,29
2018,17,BAL,CLE,26,24,2,1,0,-4.5,4.5,41,50
2018,17,NYG,DAL,35,36,-1,0,0,-7,7,42.5,71
2018,17,GB,DET,0,31,-31,0,0,-7,7,44,31
2018,17,TEN,IND,17,33,-16,0,0,3,-3,44,50
2018,17,HOU,JAC,20,3,17,1,1,-8.5,8.5,40.5,23
2018,17,BUF,MIA,42,17,25,1,1,-3.5,3.5,38.5,59
2018,17,NE,NYJ,38,3,35,1,1,-12.5,12.5,47.5,41
2018,17,KC,OAK,35,3,32,1,1,-13.5,13.5,54,38
2018,17,DEN,SD,9,23,-14,0,0,6.5,-6.5,41.5,32
2018,17,LARM,SF,48,32,16,1,1,-9,9,50.5,80
2019,1,MIN,ATL,28,12,16,1,1,-4,4,47.5,40
2019,1,MIA,BAL,10,59,-49,0,0,5,-5,37.5,69
2019,1,NYJ,BUF,16,17,-1,0,0,-3,3,39.5,33
2019,1,SEA,CIN,21,20,1,1,0,-9.5,9.5,43.5,41
2019,1,OAK,DEN,24,16,8,1,1,-1,1,43,40
2019,1,ARI,DET,27,27,0,0,1,2.5,-2.5,47.5,54
2019,1,CHI,GB,3,10,-7,0,0,-3,3,46,13
2019,1,NO,HOU,30,28,2,1,0,-7,7,53,58
2019,1,SD,IND,30,24,6,1,0,-7,7,44,54
2019,1,JAC,KC,26,40,-14,0,0,4,-4,52,66
2019,1,CAR,LARM,27,30,-3,0,0,2.5,-2.5,50.5,57
2019,1,DAL,NYG,35,17,18,1,1,-7,7,45.5,52
2019,1,NE,PIT,33,3,30,1,1,-6,6,51,36
2019,1,TB,SF,17,31,-14,0,0,-1,1,49.5,48
2019,1,CLE,TEN,13,43,-30,0,0,-5.5,5.5,45.5,56
2019,1,PHI,WAS,32,27,5,1,0,-8.5,8.5,45.5,59
2019,2,BAL,ARI,23,17,6,1,0,-13,13,42.5,40
2019,2,NYG,BUF,14,28,-14,0,0,2.5,-2.5,42.5,42
2019,2,DEN,CHI,14,16,-2,0,0,-1,1,40.5,30
2019,2,NYJ,CLE,3,23,-20,0,0,2.5,-2.5,46,26
2019,2,WAS,DAL,21,31,-10,0,0,4.5,-4.5,44,52
2019,2,TEN,IND,17,19,-2,0,0,-3,3,44,36
2019,2,HOU,JAC,13,12,1,1,0,-8,8,44.5,25
2019,2,OAK,KC,10,28,-18,0,0,8,-8,52,38
2019,2,GB,MIN,21,16,5,1,1,-3,3,45.5,37
2019,2,MIA,NE,0,43,-43,0,0,15,-15,47,43
2019,2,LARM,NO,27,9,18,1,1,-3,3,54,36
2019,2,ATL,PHI,24,20,4,1,1,1,-1,51,44
2019,2,DET,SD,13,10,3,1,1,3,-3,47,23
2019,2,PIT,SEA,26,28,-2,0,0,-3.5,3.5,46.5,54
2019,2,CIN,SF,17,41,-24,0,0,2,-2,45,58
2019,2,CAR,TB,14,20,-6,0,0,-6.5,6.5,51,34
2019,3,IND,ATL,27,24,3,1,1,-2.5,2.5,47.5,51
2019,3,KC,BAL,33,28,5,1,0,-7,7,54.5,61
2019,3,ARI,CAR,20,38,-18,0,0,2.5,-2.5,45.5,58
2019,3,WAS,CHI,15,31,-16,0,0,4,-4,42,46
2019,3,BUF,CIN,21,17,4,1,0,-5,5,42,38
2019,3,GB,DEN,27,16,11,1,1,-8,8,43.5,43
2019,3,PHI,DET,24,27,-3,0,0,-7.5,7.5,49,51
2019,3,SD,HOU,20,27,-7,0,0,-3.5,3.5,48.5,47
2019,3,CLE,LARM,13,20,-7,0,0,2.5,-2.5,51,33
2019,3,DAL,MIA,31,6,25,1,1,-20.5,20.5,47.5,37
2019,3,SEA,NO,27,33,-6,0,0,-5,5,45,60
2019,3,TB,NYG,31,32,-1,0,0,-6.5,6.5,48.5,63
2019,3,NE,NYJ,30,14,16,1,0,-20.5,20.5,46,44
2019,3,MIN,OAK,34,14,20,1,1,-7.5,7.5,43.5,48
2019,3,SF,PIT,24,20,4,1,0,-7,7,44,44
2019,3,JAC,TEN,20,7,13,1,1,2,-2,40,27
2019,4,HOU,CAR,10,16,-6,0,0,-4.5,4.5,46,26
2019,4,PIT,CIN,27,3,24,1,1,-4.5,4.5,44,30
2019,4,BAL,CLE,25,40,-15,0,0,-5.5,5.5,46.5,65
2019,4,NO,DAL,12,10,2,1,1,3,-3,46,22
2019,4,DET,KC,30,34,-4,0,1,6.5,-6.5,54,64
2019,4,CHI,MIN,16,6,10,1,1,-3,3,38,22
2019,4,BUF,NE,10,16,-6,0,1,7.5,-7.5,43.5,26
2019,4,IND,OAK,24,31,-7,0,0,-6.5,6.5,44.5,55
2019,4,GB,PHI,27,34,-7,0,0,-4.5,4.5,47.5,61
2019,4,MIA,SD,10,30,-20,0,0,16.5,-16.5,45,40
2019,4,ARI,SEA,10,27,-17,0,0,4,-4,47,37
2019,4,LARM,TB,40,55,-15,0,0,-10,10,48.5,95
2019,4,ATL,TEN,10,24,-14,0,0,-5,5,46,34
2019,4,NYG,WAS,24,3,21,1,1,-3,3,46.5,27
2019,5,CIN,ARI,23,26,-3,0,0,-4,4,48,49
2019,5,HOU,ATL,53,32,21,1,1,-4.5,4.5,48.5,85
2019,5,PIT,BAL,23,26,-3,0,1,4,-4,42.5,49
2019,5,TEN,BUF,7,14,-7,0,0,-2.5,2.5,38.5,21
2019,5,OAK,CHI,24,21,3,1,1,5.5,-5.5,41,45
2019,5,SF,CLE,31,3,28,1,1,-3,3,47.5,34
2019,5,SD,DEN,34,27,7,1,1,-6.5,6.5,44,61
2019,5,DAL,GB,24,34,-10,0,0,-4,4,48,58
2019,5,KC,IND,13,19,-6,0,0,-10,10,57,32
2019,5,SEA,LARM,30,29,1,1,1,1,-1,49,59
2019,5,NYG,MIN,10,28,-18,0,0,4.5,-4.5,45,38
2019,5,WAS,NE,7,33,-26,0,0,14.5,-14.5,46,40
2019,5,PHI,NYJ,31,6,25,1,1,-14,14,44.5,37
2019,5,NO,TB,31,24,7,1,1,-5.5,5.5,47,55
2019,6,ARI,ATL,34,33,1,1,1,2,-2,51,67
2019,6,TB,CAR,26,37,-11,0,0,-1,1,47.5,63
2019,6,BAL,CIN,23,17,6,1,0,-12,12,47.5,40
2019,6,NYJ,DAL,24,22,2,1,1,8.5,-8.5,43.5,46
2019,6,GB,DET,23,22,1,1,0,-6,6,46.5,45
2019,6,KC,HOU,24,31,-7,0,0,-7.5,7.5,55,55
2019,6,JAC,NO,6,13,-7,0,0,1,-1,45,19
2019,6,NE,NYG,35,14,21,1,1,-16.5,16.5,44.5,49
2019,6,MIN,PHI,38,20,18,1,1,-3,3,44,58
2019,6,SD,PIT,17,24,-7,0,0,-5.5,5.5,43.5,41
2019,6,CLE,SEA,28,32,-4,0,0,-2.5,2.5,47,60
2019,6,LARM,SF,7,20,-13,0,0,-4,4,48.5,27
2019,6,DEN,TEN,16,0,16,1,1,-2.5,2.5,39.5,16
2019,6,MIA,WAS,16,17,-1,0,1,3.5,-3.5,41,33
2019,7,NYG,ARI,16,22,-6,0,0,4,17,32,38
2019,7,SEA,BAL,26,38,-12,0,0,-13.5,-2,52,64
2019,7,IND,HOU,26,29,-3,0,0,-9,18,52,55
2019,7,CIN,JAC,20,12,8,1,1,-2,8,40,32
2019,7,DEN,KC,6,30,-24,0,0,-2,-6,12,36
2019,7,ATL,LARM,17,26,-9,0,0,-4,-6,34,43
2019,7,BUF,MIA,16,6,10,1,1,2.5,20.5,32,22
2019,7,DET,MIN,22,17,5,1,1,9.5,1.5,44,39
2019,7,NYJ,NE,14,31,-17,0,0,8,-37,28,45
2019,7,CHI,NO,10,18,-8,0,0,-6,7,20,28
2019,7,GB,OAK,25,23,2,1,0,-21.5,14,50,48
2019,7,DAL,PHI,30,25,5,1,0,-31.5,6.5,60,55
2019,7,TEN,SD,12,20,-8,0,0,-5.5,-19.5,24,32
2019,7,WAS,SF,14,31,-17,0,1,23,3,28,45
